4,4,4,4,4,4,4,4,4,4,4,4,4,4,4,4,4,4,4,4,4,4,1,1,1,4,4,4
4,4,4,4,4,4,4,4,4,4,4,4,4,4,4,4,4,4,4,4,4,4,3,4,2,4,4,4
4,4,4,4,4,4,4,4,4,4,4,4,4,4,4,4,4,4,4,4,4,4,3,4,2,4,4,4
3,1,1,1,1,1,4,4,4,4,4,4,4,4,4,4,4,4,4,4,4,4,3,4,2,4,4,4
3,4,4,4,4,2,1,1,1,1,1,1,1,1,4,4,4,4,3,1,1,1,1,4,2,4,4,4
3,4,4,4,4,4,4,4,4,4,4,4,4,2,4,4,4,4,3,4,4,4,4,4,2,4,4,4
0,3,4,4,4,4,2,0,0,0,0,0,4,2,1,1,1,4,3,4,4,4,4,4,2,1,1,2
4,0,0,0,0,0,0,4,4,4,4,3,4,4,4,4,2,4,3,4,4,4,4,4,4,4,4,2
4,4,4,4,4,4,4,4,4,4,4,3,4,4,4,4,2,4,3,4,4,2,3,4,4,4,4,2
4,4,4,4,4,4,4,4,4,1,1,3,4,4,4,4,2,4,3,4,4,2,3,4,4,4,4,2
4,4,4,4,4,4,4,4,4,3,4,4,4,4,0,0,2,4,3,4,4,4,4,4,4,4,4,2
4,4,4,4,4,4,4,4,4,3,4,4,4,4,2,4,4,4,3,4,4,4,4,4,4,4,4,2
4,4,4,4,4,4,4,4,4,3,4,4,4,4,2,4,4,4,3,0,4,4,2,0,0,0,0,0
4,4,4,4,4,4,4,4,4,3,4,4,4,4,2,4,4,4,4,3,4,4,2,4,4,4,4,4
4,4,4,4,4,4,4,4,4,3,0,0,4,2,1,4,4,4,4,3,4,4,1,1,2,4,4,4
4,4,4,4,4,4,4,4,4,4,1,3,4,2,4,4,3,1,1,1,4,4,4,4,2,4,4,4
4,4,4,4,4,4,4,4,4,4,3,4,4,2,1,1,1,4,4,4,4,4,4,4,2,4,4,4
4,4,4,4,4,4,4,4,4,4,3,4,4,4,4,4,4,4,2,0,0,0,0,0,0,4,4,4
4,4,4,4,4,4,4,4,4,4,3,4,4,4,4,0,0,0,0,4,4,4,4,4,4,4,4,4
4,4,4,4,4,4,4,4,4,4,3,4,4,4,4,2,4,4,4,4,4,4,4,4,4,4,4,4
4,4,4,4,4,4,4,4,4,4,3,4,4,4,4,2,4,4,4,4,4,4,4,4,4,4,4,4
4,4,4,4,4,4,4,4,4,4,0,0,0,0,0,0,4,4,4,4,4,4,4,4,4,4,4,4
